██╗    ██╗██╗███╗   ██╗███╗   ██╗███████╗██████╗ 
██║    ██║██║████╗  ██║████╗  ██║██╔════╝██╔══██╗
██║ █╗ ██║██║██╔██╗ ██║██╔██╗ ██║█████╗  ██████╔╝
██║███╗██║██║██║╚██╗██║██║╚██╗██║██╔══╝  ██╔══██╗
╚███╔███╔╝██║██║ ╚████║██║ ╚████║███████╗██║  ██║
 ╚══╝╚══╝ ╚═╝╚═╝  ╚═══╝╚═╝  ╚═══╝╚══════╝╚═╝  ╚═╝
                                                      
